[
    [ 3,  3, 28,  1, 26,  8,  0,  5, 28,  1, 26,  0],
    [ 0,  0, 19,  1,  1, 18,  0,  0, 19,  1,  1, 18],
    [ 0,  0, 19,  1,  1, 18,  0,  0, 19,  1,  1, 18],
    [12,  0,  0, 20, 20,  0,  0,  0, 19,  1, 22,  0],
    [ 3, 15, 19, 25, 25, 18,  0, 14, 15, 20,  0,  0],
    [ 0,  0, 19,  1,  1, 18,  0,  0,  0,  0,  0,  0],
    [12,  0, 19,  1, 22,  0, 13,  0,  0,  0,  0,  0],
    [ 3, 15, 19,  1, 18,  0,  6,  0, 19, 25, 18,  0],
    [ 0,  0, 19,  1, 18,  0,  6, 19, 25,  1,  9,  9],
    [12,  0,  0, 20,  0, 14,  8, 19,  1,  1,  3,  3],
    [ 7,  0, 19, 25, 18,  0,  0, 19,  1, 22,  0,  0],
    [ 2, 12, 19,  1, 18,  0,  0,  0,  0,  0,  0,  0]
]